NO ./xpm_files/CN.xpm
SO ./xpm_files/CS.xpm
WE ./xpm_files/CE.xpm
EA ./xpm_files/CW.xpm

F 199,143,143
C 44,77,111

1111111111111111111111111
1000000000110000000000001
1000000000110000000000001
1000000000110000000000001
1000000000110000000000001
100E000000000000000000001
1000000000000000000000001
1111111111111111111111111